25,25,level1 
0001000000001100000000000
0111111111111110001111010
0111111110111110000110000
0101001010111100000110000
0101101000000100000000010
0000000001010001000010000
0000000001011010100010110
0000000001111110000000010
0100000000111110000011111
0100000000011100001000011
0100000000011100000111110
0111000000011100010110010
0000000000110000001010010
0100000000000000010000010
0000000000100000100000010
0000000000100000000000010
0100000000000001000000011
0111000111000001000000010
0110000111000000100110010
0100000110000110001111010
0100010000000100000111110
0000111100000000000111000
0111110101000010101011000
0111111111110111111111110
0110000001000001100001000
