10,10,level1 
1111111111
1000001001
1000100011
1000110011
1010111001
1100000001
1001010111
1010001011
1101000001
1111111111
